11111111
11C000E1
10001111
1C001111
10000C01
11111101
1P000001
11111111