11111111
110000E1
10001111
10001111
10000001
11111101
1P000001
11111111